R	2000 1080
NO	./source/texture/Wallpaper.xpm
SO	./source/texture/Wallwood_stone.xpm
WE	./source/texture/Wallstone.xpm
EA	./source/texture/Wallmetal.xpm

S	./s
F	120,175,87
C	104,0,253

1111111111111111111111111111111111111111111111111111111
1E00001000000000000000000000000000000000000000000000001
1000001000000000000000000000000000000000000000000000001
1111001000000000000000000000000000000000000000000000001
1000011000000111111111111111100000000000000000000000001
1000000000001000000000000001111000000000000000001111111
1111111111110000000000000000000000000000000000001111111
1000000000000000000111111000000000000000000000000001111
1001111111111111111111111000000000000000000000000000011
1000000000000000000000011000000000000000000000000000011
1000000000000000000000011000000000000000000000000000001
1111111111111111111100011111111111111111111111111111111
1000000000100000000000010000000000000000000000000000001
1001111100100000000000010000000000000000000000000000001
1000001000100000000111111100000000000000000000000000001
1110001000000000000011111000000000000000000000000000001
1000001111111111111111110000000000000000000010000000001
1000000000000000000000000000000000000000000000000000001
1111111111111111111111111111111111111111111111111111111
