R	2000 1080
NO	./source/texture/Wallwood_stone.xpm
SO	./source/texture/Wallwood_stone.xpm
WE	./source/texture/Wallwood_stone.xpm
EA	./source/texture/Wallwood_stone.xpm

S	./s
F  	120,175,87
C	104,0,253

011111111111111111111111111111111111111111111111111111111111111111111111111111111111111111111
1000000000000001111000000011111111110000000111111111111110000000000111100000011111110000000110
1000000000000001111000000011111111110000000111111111000000000000000111100000011111000000000110
1000000000000001111000000011111111110000000111111100000000000000000111100000011000000000011110
1000000111111111111000000011111111110000000111110000000001111111111111100000010000000011111110
1000000000000001111000000011111111110000000111100000000111111111111111100000000000001111111110
1000000000000001111000000011111111110000000111100000000111111111111111100000000000011111111110
1000000000000001111000000011111111110000000111100000000111111111111111100000000000111111111110
1000000111111111111100000001111111111000000011110000000011111111111111100000010000001111111110
1000001111111111111000000001111111100000000111111000000001111111111111100000011000000001111110
1000001111111111111000000000111111000000000111111100000000000000000111100000011110000000011110
1000001111111111111100000000000000000000001111111111000000000000000111100000011111100000000110
1000001111111111111111100000000000000001111111111111111110000000000111100000011111111000000110
100N000000000000000000000000000000000000000000000000000000000000000000000000000000000000000110
111111111111111111111111111111111111111111111111111111111111111111111111111111111111111111111
