R	2000 1080
NO	./source/texture/Wallmetal.xpm
SO	./source/texture/Wallmetal.xpm
WE	./source/texture/Wallmetal.xpm
EA	./source/texture/Wallmetal.xpm

S	./s
F  	120,175,87
C	104,0,253

111111111111111111111111111111111111111111111111111111111111111111111111111111111111111111111
100000000000000111100000001111111111000000011111111111111000000000011110000001111111000000011
100000000000000111100000001111111111000000011111111100000000000000011110000001111100000000011
100000000000000111100000001111111111000000011111110000000000000000011110000001100000000001111
100000011111111111100000001111111111000000011111000000000111111111111110000001000000001111111
100000000000000111100000001111111111000000011110000000011111111111111110000000000000111111111
100000000000000111100000001111111111000000011110000000011111111111111110000000000001111111111
100000000000000111100000001111111111000000011110000000011111111111111110000000000011111111111
100000111111111111100000001111111111000000011110000000011111111111111110000001000000111111111
100000111111111111100000000111111110000000011111100000000111111111111110000001100000000111111
100000111111111111100000000011111100000000011111110000000000000000011110000001111000000001111
100000111111111111110000000000000000000000111111111100000000000000011110000001111110000000011
100000111111111111111110000000000000000111111111111111111000000000011110000001111111100000011
100N00000000000000000000000000000000000000000000000000000000000000000000000000000000000000011
111111111111111111111111111111111111111111111111111111111111111111111111111111111111111111111
